13
20
####################
#  !               #
#           !      #
#        D    DDD +#
#@       #    ######
####### D   ##     #
#       ##       ! #
#     +   ##   *   #
#     ##      ##   #
#   D D D        ^ #
#   #####  #     # #
#/      D  ######**#
####################
