13
20
####################
#                  #
#                  #
#         DD       #
#  @  +   ##   D ^+#
#  #####D     ######
#** !   ##  ##     #
####  D  #     D   #
#     ##  ##  ##   #
#             #    #
#      D D  D##    #
#/   ##########+ **#
####################

